Abrasi==Pengikisan
Absah==Sah==Legal
Absolut==Mutlak
Absurd==Janggal
Acum==Rujukan
Ad interim==Sementara
Adjektiva==Kata sifat
Afeksi==Kasih sayang
Agresi==Serangan
Agunan==Jaminan
Ahli==Pakar
Akselerasi==Percepatan
Akurat==Seksama
Almanak==Penanggalan
Ambiguitas==Bermakna ganda
Andal==Tangguh
Anemia==Kurang darah
Anggaran==Aturan
Anjung==Panggung
Antagonis==Berlawanan
Anulir==Abolisi
Api==Barah
Aplikasi==Pelaksanaan
Arogan==Sombong
Artis==Seniman
Asa==Harapan
Asterik==Tanda bintang
Asumsi==Anggapan
Bahari==Laut
Bahtera==Perahu
Bala==Bencana
Bandela==Peti kemas
Barbar==Tidak beradab
Berdikari==Mandiri
Bergaul==Berteman
Berongsang==Marah-marah
Berpretensi==Prasangka
Bhineka==Berbeda-beda
Bicu==Dongkrak
Biologi==Hayati
Bisa==Dapat
Boga==Makanan kenikmatan
Bonafide==Dapat dipercaya
Bromocorah==Residivis
Bubut==Cabut
Bukti diri==Identitas
Bungalow==Pesanggrahan
Bura==Sembur
Burkak==Cadar
Centeng==Body guard
Citra==Gambaran
Copyright==Hak cipta
Dampak==Akibat
Darma==Pengabdian
Daur==Siklus
Deduksi==Konklusi
Defleksi==Penyimpangan
Dehidrasi==Kehilangan cairan tubuh
Dekade==Dasa warsa
Dekadensi==Kemerosotan moral
Delusi==Ilusi
Demagog==Tiran
Demisioner==Habis masa jabatan
Deportasi==Pembuangan ke luar negeri
Derivasi==Afiksasi
Deskripsi==Pelukisan
Diagnosis==Penaksiran
Dialog==Obrolan
Dikotomi==Dibagi dua
Dinamis==Bergerak maju
Disharmoni==Tidak selaras
Diskriminasi==Subordinat
Disorientasi==Salah tujuan
Disparitas==Perbedaan
Dispensasi==Pengecualian
Ditenggak==Ditelan bulat-bulat
Divestasi==Pelepasan
Dominasi==Penguasaan
Donasi==Bantuan
Dosis==Takaran
Dursila==Jahat
Ebi==Udang kering
Ebonit==Kayu hitam
Ekonomis==Hemat
Eksibisi==Perunjukan
Ekskavasi==Penggalian
Eksklusif==Tertentu
Ekspansi==Perluasan
Eksploitasi==Pendayagunaan
Ekspresi==Aktualisasi diri
Ekstensi==Perluasan
Ekuilibrium==Keseimbangan
Elaborasi==Penjelasan terperinci
Embargo==Larangan
Embarkasi==Keberangkatan
Empati==Ikut merasakan
Empiris==Realitas
Endemi==Wabah
Epilog==Penutup
Ereksi==Birahi
Estetika==Keindahan
Estimasi==Perkiraan
Etos==Pandangan hidup
Evakuasi==Pengungsian
Evaluasi==Penilaian
Evokasi==Penggugah rasa
Fauna==Hewan
Fenomena==Kenyataan
Fertile==Subur
File==Arsip
Fitnah==Rekaan
Flegmatis==Bertemperamen lamban
Flora==Tanaman
Forum==Lembaga
Frekuwensi==Sinyal
Friksi==Bentrokan
Frustasi==Putus Harapan
Fundamental==Mendasar
Fungi==Jamur
Fusi==Gabugan
Futuristis==Menuju masa depan
Galat==Keliru
Gemar==Getol
Generik==Umum
Genjah==Cepat berbuah
Genre==Aliran
Geothermal==Panas bumi
Getir==Pahit
Global==Dunia
Glosarium==Kamus ringkas
Gongseng==Sangrai
Grasi==Pengampunan hukuman
dari presiden
Green belt==Jalur hijau
Harmonis==Serasi
Harta benda==Mal
Hayati==Hidup
Hedonisme==Hura-hura
Hegemoni==Intervensi
Hepotenusa==Sisi miring
Herbi==Berhubungan dengan
tumbuh-tumbuhan
Heroisme==Jiwa kepahlawanan
Heterogen==Tidak sejenis
Higienis==Bersih
Hiperbola==Berlebihan
Holistik==Keseluruhan
Homogen==Sejenis
Huma==Lahan
Humanisme==Kemanusiaan
Identitas==Bukti diri
Imbas==Efek
Imbasan==Isapan
Implikasi==Akibat
Implisit==Tersirat
Impulsif==Spontan
Indolen==Lesu
Infiltrasi==Penyusupan
Inheren==Melekat
Injeksi==Suntik
Inovasi==Penemuan
Insentif==Bonus
Insinuasi==Sindiran
Insomnia==Tidak bisa tidur
Inspeksi==Pemeriksaan
Insting==Naluri
Instruktur==Pelatih
Instrumental==Fragmental
Interaksi==Hubungan
Interpelasi==Hak bertanya
Intuisi==Bisikan Hati
Invasi==Pencaplokan
Investigasi==Pemeriksaan
Ironi==Bertentangan dengan
harapan
Iterasi==Perulangan
Jajak==Telaah
Jargon==Slogan
Jeda==Jarak
Jemawa==Angkuh
Jumantara==Awang-awang
Kaldera==Kawah
Kampiun==Juara
Kapital==Modal
Kapling==Tanah yang sudah
dipetak-petak
Karakteristik==Ciri
Karat==Zat oksidasi
Karnivora==Hewan pemakan daging
Kawat==Dawai
Kecenderungan==Kesamaan
Kedap==Rapat
Kekeh==Gelak tawa
Kelenger==Pingsan
Keletah==Genit
Kendala==Hambatan
Khayalan==Imajinasi
Kisi-kisi==Terali
Klarifikasi==Penjelasan
Klimaks==Titik puncak
Kolaborasi==Kerja sama
Kolong==Rongga di bawah rumah
Komedi==Lawak
Kompatriot==Rekan senegara
Kompendium==Ringkasan
Komplotan==Persekutuan
Konduite==Perilaku
Kondusif==Aman
Konfiden==Yakin
Konfrontasi==Pertikaian
Konkaf==Cekung
Konklusi==Kesimpulan
Konkret==Nyata
Konkurensi==Sengketa
Konsensus==Mufakat
Konservasi==Perlindungan
Konspirasi==Persekongkolan
Konstan==Kontinu
Kontemporer==Pada masa ini
Kontiniu==Bersambung
Kontradiksi==Pertentangan
Konveks==Cembung
Konvoi==Pergerakan
Korelasi==Hubungan
Koreografi==Ilmu tari
Kreasi==Ciptaan
Kredibel==Andal
Kredibilitas==Dapat dipercaya
Krusial==Penting
Kudeta==Perebutan kekuasaan
Kudus==Suci
Kuliner==Masakan
Kulminasi==Klimaks
Kuno==Antik
Laba==Keuntungan
Landskap==Pertamanan
Latif==Indah
Liga==Perserikatan
Loka==Tempat
Majemuk==Beragam
Makar==Muslihat
Makelar==Pialang
Mal==Harta benda
Mala==Bencana
Manunggal==Bersatu
Mayapada==Dunia
Mediator==Perantara
Mekar==Mengembang
Mengecoh==Mengakali
Militan==Agresif
Misteri==Rahasia
Mistifikasi==Sakralisasi
Mistik==Gaib
Mitra==Kawan
Mixer==Aduk-aduk
Mobilitas==Gerak
Model==Contoh
Monoton==Terus-menerus
Motilitas==Gerak
Mudun==Beradab
Mutakhir==Terkini
Mutakhir==Terkini
Aristo Cha ndra & Team 5
Mutilasi==Pemotongan
Nabati==Botani
Naratif==Terinci
Nir==Tidak
Nisbi==Relatif
Niscaya==Pasti
Norma==kebiasaan
Nuansa==Perbedaan makna
Omnivora==Hewan pemakan daging
dan tumbuh-tumbuhan
Opas==Pesuruh
Oral==Berkaitan dengan mulut
Orisinil==Asli
Ortodok==Konservatif
Otodidak==Belajar sendiri
Oval==Bulat telur
Pangkas==Potong
Paparan==Gambaran
Paradigma==Kerangka berpikir
Paradoks==Lawan asas
Paradoksal==Kontras
Paras==Wajah
Paripurna==Sempurna
Partikelir==Swasta
Paseban==Penghadapan
Pedagogi==Pengajaran
Pedoman==Panduan
Pembatasan==Restriksi
Pemugaran==Perbaikan
Pencerahan==Kesadaran
Perdeo==Gratis
Perforasi==Perlubangan
Perlop==Cuti
Pingsan==Kelenger
Pioner==Perintis
Plagiator==Penjiplak
Planning==Rencana
Poly==Banyak
Preman==Partikelir
Premi==Iuran pertanggungan
Preposisi==Kata depan
Prestise==Martabat
Pretensi==Pura-pura
Primer==Utama
Prominen==Kondang
Promotor==Penganjur
Prosedur==Mekanisme
Proteksi==Perlindungan
Protesis==Buatan
Rabat==Potongan harga
Rahib==Pendeta
Ralat==Pembetulan
Rambang==Acak
Rancu==Kacau
Random==Secara acak
Rapel==Pembayaran sekaligus
Rapuh==Ringkih
Ratifikasi==Pengesahan
Referensi==Surat keterangan
Relasi==Rekanan
Rendezvous==Pertemuan
Residu==Sisa
Restriksi==Pembatasan
Ringkih==Rapuh
Risi==Khawatir
Romansa==Kisah cinta
Rona==Warna
Sahih==Benar
Sandang==Pakaian
Sanksi==Hukuman
Sapta==Bilangan
Sasana==Gelanggang
Selebaran==Risalah
Semboyan==Slogan
Serebrum==Otak besar
Seremoni==Perayaan
Serikat==Perkumpulan
Sine qua non==Harus ada
Sinkron==Sesuai
Sintesis==Buatan
Somasi==Gugatan
Sosialisasi==Pengenalan
Spesifik==Khusus
Sporadis==Jarang
Stagnasi==Kemacetan
Standar==Baku
Statis==Tidak aktif
Stigma==Cacat
Strata==Tingkatan
Strategi==Taktik
Sumbang==Tidak sinkron
Supervisi==Pengawasan
Sutradara==Pengarah adegan
Swatantra==Otonomi
Syahdan==Konon
Ta’aruf==Perkenalan
Tabiat==Watak
Talenta==Bakat
Tandang==Lawatan
Tanggal==Lepas
Tangkal==Cegah
Tanur==Perapian
Taraf==Tingkat
Target==Sasaran
Telatah==Gerak-gerik
Tendensi==Kecenderungan
Tentatif==Belum pasti
Termin==Tahap
Timpang==Tak seimbang
Tiran==Diktator
Trail==Kisi-kisi
Transedental==Kesinambungan
Trobadur==Penyanyi lagu cinta
Vandalisme==Destruksi
Ventilasi==Jendela
Verifikasi==Pembuktian
Versus==Lawan
Wahana==Sarana
Warta==Berita